00000000000000
00000000000000
00100000000000
01110001000000
00111001100000
01111011000000
00111101000000
01111100000000
00111110000000
01111100000000
00111110000000
00111100000000
00011110000000
00011110000000
00001110000000
00001100000000
00000100000100
00000000001100
00000000001110
00000000011100
00000000011110
00000000011110
00011000001111
00111000001111
00111100000111
00111000000110
00011100000010
00011000000000
00001000000000
00000000000000
00000000000000
00000000000000
00000000000000
01000000010000
01111101011100
11111111111100
11111111111110
11111111111110
11111111111110
11111111111110
