11011111000001
10111110000000
11111111000000
10111111100000
10111111100000
00111111100010
10111111100000
00111111100000
10111111100000
10111111100001
00111111100000
01111111000001
00111111110000
01111111000001
01111110000000
01111100000000
00111010000000
00100000000000
10000000000000
10111010000000
11111000000000
11111000000000
11111000000000
11111000000000
11111100000000
11111000000000
11111000000000
00100000000000
00001010000000
00000110000000
00000111000000
00001111000000
00001111000000
00011111000001
00111111000001
01111110000011
01111111000011
11111110000111
01111111000011
11111111000111
