11110001111111
11100011111111
11100001111111
11000011111111
10100001111111
01000011111111
10100001111111
00000001111111
10000001111111
00000001111111
10000000111111
11000001111111
11100000111111
11000001111111
11000001111111
10000001111111
10000001111111
00000001111111
10000001111111
00000001111111
01010001111111
11100001111110
01010000111110
01010000111100
01000000011100
00000000011000
00000000001000
00000000000000
00000000000001
00000000000011
00000000000111
00000000000111
00000000000011
00001100000111
00001110000011
00011110000011
00011111000011
00111111000011
00111111100011
00111111100011
