00000000000000
00000000000000
00000000000000
00000000000000
00000000000000
00000000000000
00000000000000
00000000000000
00000000000000
00000000000000
00000000000000
00000000000000
00000000000000
00000111000000
00000111100000
00001111110000
00001111111000
00011001111000
00011100111100
00111000111000
00111000011100
00110010011000
00110011001100
00110111001100
00111011000100
00100010001100
00100000000100
00101000001100
00111100001100
00111100011000
00011110011000
00011111110000
00000111110000
00000111100000
00000000000000
00000000000000
00000000000000
00000000000000
00000000000000
00000000000000
