00000000010011
00000000100011
00000000000001
00000000000011
00000011000001
00001110000010
00001111010001
00001110110010
00001110110011
00001101100010
00000101111000
00000011100000
00000011110000
00000011111000
00000011111100
00000111111100
00000111111110
00000111111110
10000111111111
10000111111111
11000011111111
11000011111111
11100001110111
11100011000111
11110001000001
11100000000000
11110000000000
11110000000000
11111111100000
11111111100000
11111111110000
11111111110000
11111111111000
11111111111001
11111111111111
11111111111111
11111111111111
11111111111111
11111111111111
11111111111111
